olá = hello
ola = hello
helo = hello
adeus = goodbye
até mais = goodbye
ate mais = goodbye
atemais = goodbye
até = goodbye
por favor = please
porfavor = please
favor = please
plss = please
obrigado = thank you
valeu = thank you
tks = thank you
brigadu = thank you
oi = hi
e aí = what's up
e ai = what's up
meu = my
nome = name
e = and
é = is
meu nome é = my name is
sou = am
você = you
seu = your
ele = he
ela = she
isso = it
nós = we
eles = they
me = me
nós = us
eles = them
dele = his
dela = her
seu = its
quem = who
o que = what
quando = when
onde = where
por que = why
como = how
sim = yes
não = no
talvez = maybe
claro = sure
claro = of course
tudo bem = alright
bom = good
ruim = bad
feliz = happy
triste = sad
cansado = tired
com fome = hungry
com sede = thirsty
quente = hot
frio = cold
grande = big
pequeno = small
longo = long
curto = short
fácil = easy
difícil = hard
rápido = fast
lento = slow
certo = right
errado = wrong
bonito = beautiful
feio = ugly
divertido = fun
chato = boring
interessante = interesting
empolgante = exciting
seguro = safe
perigoso = dangerous
limpo = clean
sujo = dirty
novo = new
velho = old
barato = cheap
caro = expensive
rico = rich
pobre = poor
inteligente = smart
estúpido = stupid
gentil = kind
maldoso = mean
amigável = friendly
hostil = unfriendly
educado = polite
rude = rude
calmo = calm
nervoso = nervous
animado = excited
entediado = bored
relaxado = relaxed
ocupado = busy
livre = free
cedo = early
tarde = late
hoje = today
amanhã = tomorrow
ontem = yesterday
agora = now
depois = later
em breve = soon
sempre = always
normalmente = usually
frequentemente = often
às vezes = sometimes
raramente = rarely
nunca = never
novamente = again
primeiro = first
último = last
próximo = next
passado = last
muitos = many
poucos = few
alguns = some
tudo = all
nenhum = none
cada = each
todo = every
ambos = both
qualquer um = either
nenhum dos dois = neither
apenas = just
somente = only
também = also
também = too
muito = very
bastante = quite
realmente = really
só = just
mais = more
menos = less
a maioria = most
o mínimo = least
suficiente = enough
demais = too much
muito pouco = too little
gostar = like
amar = love
odiar = hate
querer = want
precisar = need
ter = have
conseguir = get
levar = take
dar = give
mostrar = show
contar = tell
dizer = say
perguntar = ask
responder = answer
trabalhar = work
brincar = play
comer = eat
beber = drink
dormir = sleep
viver = live
morrer = die
andar = walk
correr = run
dirigir = drive
andar de = ride
nadar = swim
voar = fly
pular = jump
dançar = dance
cantar = sing
ouvir = listen
assistir = watch
ler = read
escrever = write
desenhar = draw
pintar = paint
cozinhar = cook
limpar = clean
ajudar = help
jogar = play
ligar = call
mensagem = text
conversar = talk
sorrir = smile
rir = laugh
chorar = cry
gritar = shout
sussurrar = whisper
pensar = think
acreditar = believe
lembrar = remember
esquecer = forget
entender = understand
saber = know
aprender = learn
Olá! = Hello!
Oi! = Hi!
Como você está? = How are you?
Tudo bem? = Everything good?
Estou bem, obrigado. = I’m fine, thank you.
E você? = And you?
Qual é o seu nome? = What’s your name?
Meu nome é... = My name is...
Prazer em conhecê-lo! = Nice to meet you!
Como vai? = How’s it going?
Que horas são? = What time is it?
Onde fica o banheiro? = Where is the bathroom?
Você fala inglês? = Do you speak English?
Não entendo. = I don’t understand.
Pode repetir, por favor? = Can you repeat, please?
Estou com fome. = I’m hungry.
O que você quer comer? = What do you want to eat?
Estou com sede. = I’m thirsty.
Você pode me ajudar? = Can you help me?
Desculpe. = Sorry.
Sem problemas. = No problem.
Tudo certo. = Everything’s okay.
Vamos lá! = Let’s go!
Você está brincando? = Are you kidding?
Fala sério! = Seriously!
Que legal! = How cool!
Que chato! = How boring!
Que estranho! = How weird!
Não sei. = I don’t know.
Pode crer! = You bet!
A verdade é... = The truth is...
Você está certo. = You are right.
Não tem problema. = No worries.
Você está com saudades? = Are you missing someone?
Que dia lindo! = What a beautiful day!
Vamos fazer isso! = Let’s do this!
Você viu isso? = Did you see that?
Estou cansado. = I’m tired.
Vamos descansar. = Let’s take a break.
O que você acha? = What do you think?
Não tenho certeza. = I’m not sure.
Isso é ótimo! = That’s great!
Que bom! = How nice!
Estou animado! = I’m excited!
O que está acontecendo? = What’s happening?
Que horas você chega? = What time will you arrive?
Estou a caminho. = I’m on my way.
Já estou indo. = I’m coming.
O que você vai fazer hoje? = What are you going to do today?
Estou assistindo TV. = I’m watching TV.
Vamos assistir a um filme? = Shall we watch a movie?
Onde você mora? = Where do you live?
Que lugar bonito! = What a beautiful place!
O que você gosta de fazer? = What do you like to do?
Estou feliz. = I’m happy.
Que dia é hoje? = What day is today?
Você tem irmãos? = Do you have siblings?
Qual é a sua cor favorita? = What’s your favorite color?
Qual é o seu filme favorito? = What’s your favorite movie?
O que você faz da vida? = What do you do for a living?
Estou estudando. = I’m studying.
Onde você trabalha? = Where do you work?
Você tem planos para o fim de semana? = Do you have plans for the weekend?
Que tal um café? = How about a coffee?
Você gosta de música? = Do you like music?
Que tipo de música você gosta? = What kind of music do you like?
Estou ouvindo uma música nova. = I’m listening to a new song.
Vamos sair? = Shall we go out?
Que horas são? = What time is it?
Você quer vir comigo? = Do you want to come with me?
Onde você comprou isso? = Where did you buy this?
Isso é muito caro. = That’s very expensive.
Você pode me mostrar? = Can you show me?
O que você prefere? = What do you prefer?
Eu prefiro... = I prefer...
Você está pronto? = Are you ready?
Vou me arrumar. = I’ll get ready.
Que bom que você veio! = I’m glad you came!
Vamos nos encontrar mais tarde. = Let’s meet later.
Você pode contar comigo. = You can count on me.
Isso não é justo. = That’s not fair.
Que bom que você está aqui! = It’s great that you’re here!
Você tem certeza? = Are you sure?
Estou apenas brincando. = I’m just kidding.
Você está fazendo o que? = What are you doing?
Posso usar seu telefone? = Can I use your phone?
Você está pronto para ir? = Are you ready to go?
Não se preocupe! = Don’t worry!
O que você quer fazer agora? = What do you want to do now?
Vou pensar sobre isso. = I’ll think about it.
Você está me ouvindo? = Are you listening to me?
Como foi seu dia? = How was your day?
Você gostaria de algo? = Would you like something?
Fico feliz em ouvir isso. = I’m glad to hear that.
Vamos fazer uma pausa. = Let’s take a break.
Espero que você tenha um bom dia. = I hope you have a good day.
O que você vai vestir? = What are you going to wear?
Você se divertiu? = Did you have fun?
Até logo! = See you later!
Tenha um ótimo dia! = Have a great day!
Beleza = Cool / Good
Massa = Awesome / Great
Tranquilo = Chill / No problem
Dar um perdido = To ghost (someone)
Pegar leve = Take it easy
Sussa = No worries / Easy
Quebrar o galho = Help out / Make do
Ficar de boa = To hang out / To chill
Valeu = Thanks / Appreciate it
Parada = Thing / Stuff
Rolê = Outing / Hangout
Top = Top-notch / Excellent
Caraca = Wow / Holy cow
Tô dentro = Count me in
Fala sério = Are you serious?
Mermão = Dude / Bro
É nóis = We’re in this together / We got this
De boa na lagoa = Chill as a cucumber
Vish = Oops / Uh-oh
Colar = To show up / To come over
Chorar as pitangas = To complain / To whine
Fazer vaquinha = To chip in
Pagar o pato = To pay the price
Encher linguiça = To beat around the bush
Meter o louco = To go crazy / To act foolishly
Queimar a largada = To jump the gun
Sair pela tangente = To evade / To dodge
Deu ruim = It went wrong
Fazer uma raiva = To get mad
Tô nem aí = I don’t care
Dar uma força = To give a hand / To help out
Cair na real = To face reality
Rodar a baiana = To freak out
Engolir sapo = To swallow your pride
Bicho = Dude / Guy
Arrebentar a boca do balão = To have a blast / To go all out
Pisar na bola = To mess up / To screw up
Estar na mesma vibe = To be on the same page
Fazer por onde = To earn it / To deserve it
Quebrar o galho = To help out / To make do
Cair no conto do vigário = To fall for a scam
Segurar a onda = To keep it together
Dar tchauzinho = To wave goodbye
Tô com saudade = I miss you
Mó = Huge / A lot
Zé Mané = Loser / Fool
Ficar na pilha = To be hyped up
Dar uma olhada = To take a look
Tava lá = I was there
E aí? = What’s up?
justo = allright
sair = leave
Isto = This
Aquilo = That
Aqui = Here
Ali / Lá = There
Agora = Now
Então = Then
Quando = When
Onde = Where
Como = How
Por que = Why
O que = What
Qual = Which
Quem = Who
A quem = Whom
O deles / Dele = Their
O seu (para objetos ou animais) = Its
O nosso = Our
O seu = Your
Alguns = Some
Qualquer = Any
Muitos = Many
Muito = Much
Poucos = Few
Pouco = Little
Todos = All
Ambos = Both
Cada = Each
Qualquer um = Either
Nenhum dos dois = Neither
Apenas = Just
Somente = Only
Também = Also
Demais = Too
Muito = Very
Realmente = Really
Bem = Well
Mal = Badly
Rapidamente = Quickly
Lentamente = Slowly
Cuidadosamente = Carefully
Facilmente = Easily
Frequentemente = Often
Às vezes = Sometimes
Sempre = Always
Nunca = Never
Antes = Before
Depois = After
Durante = During
Até = Until
Desde = Since
E = And
Mas = But
Ou = Or
Então = So
Porque = Because
Embora = Although
Embora = Though
Se = If
A menos que = Unless
Enquanto = While
Como / Assim como = As
Quando = When
Sempre que = Whenever
Onde quer que = Wherever
Antes que = Before
Depois que = After
Desde que = Since
Até que = Until
Em = In
Em / Sobre = On
Em / No = At
Por = By
Com = With
Sobre = About
Para = For
Para = To
De = From
Através de = Through
Qual seu nomne = What’s your name
seu nome = your name
sair = exit
foi = was
como foi = how it was
dia = day
diariamente = daily
como foi seu dia = how was your day
Foi = Was
Era = Was (used for descriptions or habitual actions)
Teve = Had
Tinha = Had (used for possession in the past)
Fazia = Did / Made
Vivia = Lived
Estava = Was (used for states or conditions)
Sentia = Felt
Fui = Went / Was
Disse = Said
Viu = Saw
Ouviu = Heard
Escreveu = Wrote
Leu = Read
Fui = Went
Comeu = Ate
Bebeu = Drank
Falou = Spoke
Correu = Ran
Andou = Walked
Jogou = Played
Trabalhou = Worked
Estudou = Studied
Aprendeu = Learned
Amou = Loved
Odou = Hated
Chorou = Cried
Riu = Laughed
Sorria = Smiled
Esperou = Waited
Naquela época = At that time
Antigamente = In the past
Há muito tempo = A long time ago
Quando era criança = When I was a child
Em tempos antigos = In ancient times
No passado = In the past
Certa vez = Once
Em um dia = On a day
Uma vez = Once
No ano passado = Last year
Durante a infância = During childhood
No fim de semana passado = Last weekendNaquela época = At that time
Antigamente = In the past
Há muito tempo = A long time ago
Quando era criança = When I was a child
Em tempos antigos = In ancient times
No passado = In the past
Certa vez = Once
Em um dia = On a day
Uma vez = Once
No ano passado = Last year
Durante a infância = During childhood
No fim de semana passado = Last weekend
é = is
um = a
dos = of the
melhores = best
dobráveis = foldables
estilo = style
que = that
há = there is
por aí = around
contar = to have
com = with
processadores = processors
mais = more
potentes = powerful
capazes = capable
rodar = to run
em = in
altas = high
frequências = frequencies
para = to
garantir = ensure
grande = great
desempenho = performance
mesmo = even
que = that
não = not
ofereça = offers
mudanças = changes
ou = or
atualizações = updates
relação = relation
analisa = analyzes
aparelho = device
tem = has
anos = years
atualizações = updates
Android = Android
mas = but
alerta = warns
celular = phone
para = for
jogos = games
vídeos = videos
são = are
publicados = published
de = from
segunda = Monday
a = to
sexta-feira = Friday
a partir de = starting from
sábado = Saturday
domingo = Sunday
rede = social network
buscando = searching
por = for
em = in
todas = all
O = the
dois mil e dez = twenty ten
dois mil e onze = twenty eleven
dois mil e doze = twenty twelve
dois mil e treze = twenty thirteen
dois mil e quatorze = twenty fourteen
dois mil e quinze = twenty fifteen
dois mil e dezesseis = twenty sixteen
dois mil e dezessete = twenty seventeen
dois mil e dezoito = twenty eighteen
dois mil e dezenove = twenty nineteen
dois mil e vinte = twenty twenty
dois mil e vinte e um = twenty twenty-one
dois mil e vinte e dois = twenty twenty-two
dois mil e vinte e três = twenty twenty-three
dois mil e vinte e quatro = twenty twenty-four
um = one
dois = two
três = three
quatro = four
cinco = five
seis = six
sete = seven
oito = eight
nove = nine
dez = ten
onze = eleven
doze = twelve
treze = thirteen
quatorze = fourteen
quinze = fifteen
dezesseis = sixteen
dezessete = seventeen
dezoito = eighteen
dezenove = nineteen
vinte = twenty
vinte e um = twenty-one
vinte e dois = twenty-two
vinte e três = twenty-three
vinte e quatro = twenty-four
vinte e cinco = twenty-five
vinte e seis = twenty-six
vinte e sete = twenty-seven
vinte e oito = twenty-eight
vinte e nove = twenty-nine
trinta = thirty
trinta e um = thirty-one
trinta e dois = thirty-two
trinta e três = thirty-three
trinta e quatro = thirty-four
trinta e cinco = thirty-five
trinta e seis = thirty-six
trinta e sete = thirty-seven
trinta e oito = thirty-eight
trinta e nove = thirty-nine
quarenta = forty
quarenta e um = forty-one
quarenta e dois = forty-two
quarenta e três = forty-three
quarenta e quatro = forty-four
quarenta e cinco = forty-five
quarenta e seis = forty-six
quarenta e sete = forty-seven
quarenta e oito = forty-eight
quarenta e nove = forty-nine
cinquenta = fifty
cinquenta e um = fifty-one
cinquenta e dois = fifty-two
cinquenta e três = fifty-three
cinquenta e quatro = fifty-four
cinquenta e cinco = fifty-five
cinquenta e seis = fifty-six
cinquenta e sete = fifty-seven
cinquenta e oito = fifty-eight
cinquenta e nove = fifty-nine
sessenta = sixty
sessenta e um = sixty-one
sessenta e dois = sixty-two
sessenta e três = sixty-three
sessenta e quatro = sixty-four
sessenta e cinco = sixty-five
sessenta e seis = sixty-six
sessenta e sete = sixty-seven
sessenta e oito = sixty-eight
sessenta e nove = sixty-nine
setenta = seventy
setenta e um = seventy-one
setenta e dois = seventy-two
setenta e três = seventy-three
setenta e quatro = seventy-four
setenta e cinco = seventy-five
setenta e seis = seventy-six
setenta e sete = seventy-seven
setenta e oito = seventy-eight
setenta e nove = seventy-nine
oitenta = eighty
oitenta e um = eighty-one
oitenta e dois = eighty-two
oitenta e três = eighty-three
oitenta e quatro = eighty-four
oitenta e cinco = eighty-five
oitenta e seis = eighty-six
oitenta e sete = eighty-seven
oitenta e oito = eighty-eight
oitenta e nove = eighty-nine
noventa = ninety
noventa e um = ninety-one
noventa e dois = ninety-two
noventa e três = ninety-three
noventa e quatro = ninety-four
noventa e cinco = ninety-five
noventa e seis = ninety-six
noventa e sete = ninety-seven
noventa e oito = ninety-eight
noventa e nove = ninety-nine
cem = one hundred